00010000 1
00010004 2
00010008 3
00010012 5
00010016 8
