int main () {
  y = '\a';
  y = '\b';
  y = '\f';
  y = '\n';
  y = '\r';
  y = '\t';
  y = '\v';
  y = '\\';
  y = '\'';
  y = '\"';
  y = '\?';
}
