00010000 1
00010001 0
00010002 1
00010003 0
00020000 1
